R 640 480
NO ./textures/1.xpm
SO ./textures/2.xpm
WE ./textures/3.xpm
EA ./textures/4.xpm

S ./textures/5.xpm
F 190,210,100
C 180,230,240

        1111111111111111111111111
        1000000000110000000000001
        1011000001110000002000001
        1001002000000000000000001
111111111011000001110000000000001
100000000011000001110111111111111
111101111111110111200000010001
1111000111111101110000000100011111111
1100200011010101110010N000000000000001
100220000000200011001000000000000100011111
102000000000000000000000000000000010010001
110000011101010111000011110001111111111111
11110111 1110101 100011101001
11111111 1111111 111111111111
