R 1280 1024
NO ./textures/1.xpm
SO ./textures/2.xpm
WE ./textures/3.xpm
EA ./textures/4.xpm

S ./textures/5.xpm
F 188,229,92
C 178,235,244

        1111111111111111111111111
        1000000000110000000000001
        1011000001110000002000001
        1001002000000000000000001
111111111011000001110000000000001
100000000011000001110111111111111
111101111111110111200000010001
1111000111111101110000000100011111111
11002000110101011100100000000000000001
100220000000200011001000000000000100011111
102000W00000000000000000000000000010010001
110000011101010111000011110001111111111111
1111000000000010101100011101001
1111111111111111111111111111111
